9,4,8,9,3,13,11,2,13,5,8,14,11,2,4,4,9,5,7,5,13,10,15,14,11,11,9,9,9,6,13,7,2,0,8,2,2,4,5,9
7,14,9,7,7,1,11,9,8,4,14,15,15,9,12,4,3,7,5,14,4,8,11,10,11,14,5,6,8,9,13,8,15,0,8,13,4,7,5,13
2,2,13,12,10,10,15,9,2,8,12,5,0,2,12,13,5,12,6,15,5,13,15,12,2,12,3,2,6,4,7,13,10,0,9,11,12,8,3,1
13,15,15,1,11,8,8,8,11,10,3,8,3,2,4,2,12,13,13,1,8,12,2,0,14,10,15,11,14,7,0,3,10,1,2,8,6,1,15,9
11,4,12,11,0,11,10,10,10,1,15,6,1,6,8,2,7,9,3,2,7,0,15,9,0,5,8,12,4,11,1,10,9,12,9,3,3,4,5,0
1,7,4,15,5,4,10,4,5,3,7,11,14,15,6,14,0,15,7,6,4,14,0,6,13,12,1,9,2,5,4,4,13,0,15,6,10,5,1,13
2,6,7,3,1,5,11,7,11,6,0,3,0,15,5,14,13,8,11,12,1,9,3,2,1,15,0,14,5,15,1,11,15,5,4,11,6,8,1,15
13,0,7,1,13,15,15,14,3,11,5,11,2,6,8,12,7,3,12,12,14,3,11,10,12,1,12,10,2,12,10,9,10,8,4,10,4,4,3,15
0,15,11,2,13,13,1,4,1,9,0,1,9,15,9,14,0,13,11,7,14,7,3,1,8,12,7,10,7,8,3,8,9,10,5,8,5,5,14,0
3,15,11,5,3,9,6,10,1,5,8,8,11,0,11,14,0,13,3,9,11,15,4,5,3,5,9,2,5,14,1,2,3,9,15,11,12,5,14,11
6,1,3,4,3,13,9,13,3,8,13,10,2,4,13,13,1,5,15,4,14,4,15,0,3,15,15,11,12,8,10,15,12,11,5,14,7,13,9,4
5,10,3,10,13,7,13,14,3,6,9,11,9,6,8,4,1,1,4,7,6,7,11,4,11,6,3,14,0,7,11,7,9,9,5,14,15,9,7,11
7,15,13,15,7,2,0,3,3,12,2,7,0,8,7,5,8,2,14,7,5,3,0,12,15,9,3,2,3,9,14,4,5,14,11,14,2,14,5,6
7,5,11,8,8,8,1,11,8,15,2,8,14,12,7,7,7,1,0,6,8,9,9,5,4,14,5,12,2,10,13,15,13,11,15,13,1,10,1,3
0,15,5,10,3,12,11,4,2,1,5,13,9,9,9,13,13,2,15,13,8,3,5,15,12,0,7,7,2,11,12,14,11,3,11,14,6,1,8,1
7,10,5,12,14,6,10,6,12,2,10,12,13,0,11,1,15,1,13,3,4,12,3,4,5,9,10,10,15,3,12,7,3,11,13,2,15,4,4,2
14,4,11,12,8,0,6,9,9,0,8,12,15,4,7,7,3,4,14,1,13,6,5,13,8,0,7,15,4,11,5,7,0,1,10,15,10,9,2,14
1,7,8,1,12,13,0,9,7,2,1,13,1,8,4,3,2,0,1,6,6,9,15,10,3,13,1,12,13,14,12,3,15,13,8,11,7,9,7,4
14,3,1,12,4,4,6,13,12,8,10,6,10,13,7,12,15,5,9,2,8,2,3,4,8,10,4,9,4,10,7,1,5,1,14,5,12,11,8,10
15,2,12,11,8,7,9,15,12,2,4,8,12,12,12,15,7,11,2,14,0,8,11,10,5,15,11,2,14,9,5,13,6,9,6,14,5,0,6,0
6,11,5,15,10,2,8,8,3,7,10,1,5,8,9,5,14,4,9,10,3,13,6,7,12,3,8,6,5,10,14,11,10,6,1,12,15,13,4,12
11,15,2,11,3,7,0,9,1,7,4,13,10,2,6,14,15,9,1,13,11,3,13,3,6,4,6,13,12,15,3,4,1,15,15,5,11,4,10,3
13,12,15,11,9,7,8,7,12,12,9,10,8,3,5,15,7,6,15,0,7,9,3,2,8,12,6,8,7,15,7,4,4,9,1,9,14,2,7,5
9,5,6,11,14,1,15,14,6,13,3,0,10,15,1,1,7,11,12,8,11,4,11,1,10,10,0,0,8,15,0,2,15,5,11,4,8,4,11,1
1,10,9,4,3,7,12,5,13,10,9,11,8,3,9,1,14,12,8,4,12,0,12,13,15,11,0,3,15,2,10,13,4,9,10,8,0,0,7,8
15,7,3,11,15,13,1,8,15,7,15,6,10,9,10,2,14,2,6,11,9,7,8,12,12,14,13,0,12,15,14,3,8,5,14,0,13,0,15,3
12,13,3,1,8,12,0,8,2,2,3,8,2,9,13,8,3,14,1,1,2,4,14,10,15,12,11,11,6,5,12,15,9,2,15,10,15,2,3,14
0,12,6,9,10,0,10,1,9,0,8,9,6,11,5,5,14,4,4,8,6,9,1,11,14,13,15,6,0,11,12,13,14,6,2,15,13,3,4,2
12,3,4,3,11,13,7,3,12,3,9,4,10,2,8,3,4,4,4,12,7,11,3,13,3,14,15,13,12,8,14,0,1,8,7,9,11,11,1,2
8,1,8,7,0,1,15,13,0,7,4,4,11,7,3,8,3,15,3,15,7,0,12,13,4,1,11,7,13,8,6,5,6,15,3,3,8,9,14,3
5,4,7,9,13,1,12,8,12,15,11,4,7,1,13,13,8,0,4,0,3,4,8,1,5,9,1,2,5,0,1,10,15,8,10,8,5,15,13,1
9,11,8,7,8,4,10,5,12,12,2,13,14,1,5,7,7,8,14,0,5,5,15,6,7,13,9,12,5,5,2,8,5,2,10,12,12,10,3,8
15,0,4,0,9,10,2,0,13,10,2,8,14,15,2,7,3,3,10,12,14,2,10,8,0,7,13,10,4,10,6,2,13,5,10,12,6,8,7,1
10,6,4,6,3,6,6,4,12,11,5,3,7,14,9,12,5,0,12,0,13,9,1,2,6,1,1,8,4,13,9,7,3,8,4,7,7,12,11,5
12,1,10,11,3,7,11,0,0,0,10,11,6,7,5,1,14,15,14,1,5,2,10,13,12,10,10,12,2,8,2,14,15,2,11,8,11,7,4,1
1,6,14,8,8,10,2,10,0,1,10,11,15,4,2,2,12,14,12,5,11,15,12,2,0,14,1,15,12,5,3,9,4,0,6,8,12,11,5,1
0,0,14,4,9,8,11,15,11,7,9,2,15,14,6,3,6,9,3,1,8,1,14,12,14,10,7,15,0,4,0,4,2,12,6,12,1,13,15,11
7,2,6,7,15,9,3,10,7,15,9,9,13,8,8,9,9,7,13,2,2,12,4,7,12,4,11,4,8,2,11,9,12,7,4,13,12,11,8,0
13,10,6,10,8,6,3,0,3,11,4,10,0,0,3,4,9,5,4,10,5,6,12,12,8,7,7,5,0,1,6,12,14,15,15,5,7,15,11,5
13,10,0,5,1,4,2,9,14,14,1,2,13,12,5,7,8,1,0,7,9,12,13,8,6,15,4,9,14,15,11,15,15,12,3,14,10,12,5,4
14,0,10,11,3,3,1,10,5,11,6,10,2,6,8,9,2,9,3,4,4,12,2,3,13,6,8,6,10,10,11,11,9,14,7,15,1,13,11,10
2,6,11,7,10,5,10,4,8,6,8,3,3,14,11,4,3,4,15,3,6,3,15,10,3,5,12,8,2,0,14,15,6,1,4,14,13,1,14,8
2,6,8,1,8,12,6,8,14,4,11,12,4,8,0,3,3,8,14,13,12,10,6,8,9,9,15,2,13,13,8,12,2,12,15,13,11,5,1,13
4,7,3,11,10,3,3,11,11,7,5,11,4,6,13,7,7,0,15,4,2,9,15,7,3,15,11,0,13,8,6,15,0,15,5,11,10,10,1,14
7,6,10,8,9,0,2,3,4,7,10,0,14,14,8,9,1,8,4,1,4,1,3,0,8,2,15,11,11,7,13,11,3,3,8,14,14,1,1,5
4,8,0,6,13,6,13,4,0,11,15,10,4,8,13,15,6,6,14,5,4,2,9,5,3,13,0,4,3,12,2,9,0,12,11,1,0,2,8,4
6,13,7,7,4,10,15,5,8,11,7,11,6,3,5,4,0,15,5,15,4,6,10,4,4,7,11,13,3,3,15,1,13,9,6,6,5,1,4,5
10,10,8,11,10,5,4,13,10,9,14,13,15,0,13,2,12,0,14,8,11,15,3,1,10,1,15,15,9,12,11,5,4,12,9,12,0,9,15,9
12,5,8,2,12,11,8,0,12,9,3,14,8,12,11,13,9,7,1,0,11,9,15,2,13,13,8,6,1,0,6,14,2,12,10,5,3,10,4,0
5,8,10,9,12,0,3,8,8,8,3,9,7,12,10,14,4,12,2,11,4,14,3,12,11,11,13,3,1,5,5,6,4,12,8,8,2,15,10,2
13,1,10,7,7,2,13,10,4,3,15,3,15,5,13,8,0,1,4,6,13,15,4,2,8,3,4,14,2,4,3,15,10,9,2,7,1,5,7,11
0,5,6,9,10,3,3,10,0,2,4,6,13,12,1,2,5,8,15,1,10,9,0,12,13,15,15,7,7,2,10,9,10,13,11,1,9,5,6,9
3,3,0,12,12,3,14,15,13,12,5,9,0,0,10,4,7,7,7,10,3,15,7,5,1,11,7,0,13,9,10,0,2,4,10,12,7,9,14,0
4,10,15,7,2,1,11,4,2,3,5,5,0,8,8,9,10,9,1,5,0,2,11,13,14,13,1,2,11,10,15,10,8,4,8,11,8,6,9,10
2,4,11,8,15,7,2,11,12,3,0,13,0,6,11,5,15,14,8,0,14,2,2,6,2,6,5,8,3,15,2,15,1,13,13,0,14,10,13,3
1,12,2,1,3,6,4,12,12,12,3,3,13,2,6,8,9,12,0,3,5,14,5,8,9,6,1,8,5,12,7,8,6,11,14,7,3,2,10,11
14,12,3,4,1,1,11,13,14,6,9,4,12,12,6,1,0,12,6,7,11,4,15,9,1,10,5,3,6,9,7,6,14,11,5,7,0,6,6,15
5,10,14,3,3,12,11,0,12,10,1,5,4,4,12,15,3,11,11,8,2,9,12,12,3,3,10,6,13,11,3,9,1,15,9,13,14,5,0,12
15,13,4,14,14,15,14,13,0,12,7,11,12,9,13,15,1,8,14,1,14,0,11,5,11,0,4,0,4,10,7,3,11,8,14,0,14,7,12,5
5,11,12,13,13,4,11,5,9,11,7,6,7,14,1,4,6,6,2,7,9,9,9,4,15,3,9,1,12,15,2,0,6,2,14,2,15,7,11,7
